10000000000000000000000000000001
10000000000000000000000000000002
10001110000000000000000000000002
10000000000000111000000000001111
30000000000000000000000000000003
30000000000000000000000000000003
11111100000000000000000001111111
10000000000000000000000000000001
10000000000000000000000000000001
10000000000000000000000000000001
10000011111000000000000000000001
10000000000000000000011110000004
10000000000000000000000000000004
10000000000111110000000000000111
10000000000000000000000000000001
10000111110000000000000000000001
10000000000000000000000100000001
10000000000000000000000000000001
10000000000000000000000000000001
40000000000000000000000000000001
40000000000000010110110110000001
10000000000000000000000000000001
10011111100000000000000000000001
20000000000000000000000000000001
20000000000000000000000000000001
11111111111000111111111111111111
